
 ██████╗ ██╗███████╗     ██████╗██╗  ██╗ █████╗ ████████╗    ██████╗  ██████╗  ██████╗ ███╗   ███╗
██╔════╝ ██║██╔════╝    ██╔════╝██║  ██║██╔══██╗╚══██╔══╝    ██╔══██╗██╔═══██╗██╔═══██╗████╗ ████║
██║  ███╗██║███████╗    ██║     ███████║███████║   ██║       ██████╔╝██║   ██║██║   ██║██╔████╔██║
██║   ██║██║╚════██║    ██║     ██╔══██║██╔══██║   ██║       ██╔══██╗██║   ██║██║   ██║██║╚██╔╝██║
╚██████╔╝██║███████║    ╚██████╗██║  ██║██║  ██║   ██║       ██║  ██║╚██████╔╝╚██████╔╝██║ ╚═╝ ██║
 ╚═════╝ ╚═╝╚══════╝     ╚═════╝╚═╝  ╚═╝╚═╝  ╚═╝   ╚═╝       ╚═╝  ╚═╝ ╚═════╝  ╚═════╝ ╚═╝     ╚═╝

