
 ██████╗ ██╗███████╗    ███████╗██╗   ██╗███████╗████████╗███████╗███╗   ███╗
██╔════╝ ██║██╔════╝    ██╔════╝╚██╗ ██╔╝██╔════╝╚══██╔══╝██╔════╝████╗ ████║
██║  ███╗██║███████╗    ███████╗ ╚████╔╝ ███████╗   ██║   █████╗  ██╔████╔██║
██║   ██║██║╚════██║    ╚════██║  ╚██╔╝  ╚════██║   ██║   ██╔══╝  ██║╚██╔╝██║
╚██████╔╝██║███████║    ███████║   ██║   ███████║   ██║   ███████╗██║ ╚═╝ ██║
 ╚═════╝ ╚═╝╚══════╝    ╚══════╝   ╚═╝   ╚══════╝   ╚═╝   ╚══════╝╚═╝     ╚═╝

